######################################
#JP...........#...............#......#
#..########...#...@...#.......#...#..#
#.........#...#.......#.......#...#..#
#..#####..#.@.#.......#.......#...#..#
#.....@#..#...#.......#...@...#.@.#..#
#......#..#...#....####.......#...#..#
#......#...........#..........#...#..#
#......#############..........#...#..#
#.......................#######...#..#
#......@....#############.......@.#..#
#...........................###...#..#
######################......###...#..#
#.....#@....................###...#..#
#..@..#...........................#..#
#.....#.......####...........#....#..#
#.....#.......####...........#..@.#..#
#.........@@.................#....#.@#
######################################