#######
#P..J.#
#.###.#
#..@#.#
#@#.@.#
#######